14 11
9 5
1 1
12 1
1 9
12 9
0 0 0 0 0 0 0 0 0 0 0 0 0 0
0 3 3 3 3 3 0 3 3 3 3 0 3 0
0 0 0 0 0 0 0 3 3 3 3 0 3 0
0 3 3 3 3 3 3 3 3 3 3 0 0 0
0 3 3 3 1 3 2 3 1 3 2 3 1 0
3 3 3 3 1 3 2 3 1 3 2 3 1 3
0 3 3 3 1 3 2 3 1 3 2 3 1 0
0 0 0 3 3 3 3 3 3 3 3 0 0 0
3 3 0 3 3 3 3 3 3 3 3 0 3 3
0 3 0 3 3 3 3 3 3 3 3 0 3 0
0 0 0 0 0 0 0 0 0 0 0 0 0 0
mapagolge.png
