19 17
9 9
1 1
1 15
17 1
17 15
0 0 0 0 0 0 0 0 0 0 0 0 0 0 0 0 0 0 0
0 1 1 1 1 1 1 1 1 0 1 1 1 1 1 1 1 1 0
0 0 0 0 1 0 0 0 1 0 1 0 0 0 1 0 0 0 0
0 1 1 1 1 1 1 1 1 2 1 1 1 1 1 1 1 1 0
0 1 0 0 1 0 1 0 0 0 0 0 1 0 1 0 0 1 0
0 1 1 1 1 0 1 1 1 0 1 1 1 0 1 1 1 1 0
0 0 0 0 1 0 0 0 1 0 1 0 0 0 1 0 0 0 0
1 2 1 1 1 0 1 1 1 2 1 1 1 0 1 1 1 2 1
0 0 0 0 1 0 1 0 0 0 0 0 1 0 1 0 0 0 0
0 1 1 1 1 1 1 1 1 1 1 1 1 1 1 1 1 1 0
0 1 0 0 1 0 1 0 0 0 0 0 1 0 1 0 0 1 0
0 1 0 1 1 0 1 1 1 0 1 1 1 0 1 1 0 1 0
0 1 0 0 1 0 0 0 1 0 1 0 0 0 1 0 0 1 0
0 1 1 1 1 1 1 1 1 1 1 1 1 1 1 1 1 1 0 
0 0 0 1 0 0 0 1 0 1 0 1 0 0 0 1 0 0 0 
0 1 1 1 1 1 1 1 0 2 0 1 1 1 1 1 1 1 0  
0 0 0 0 0 0 0 0 0 0 0 0 0 0 0 0 0 0 0 
mapagolge.png
