14 11
9 5
1 1
12 1
1 9
12 9
0 0 0 0 0 0 0 0 0 0 0 0 0 0
0 2 1 1 1 1 1 0 2 1 1 1 2 0
0 0 0 1 0 0 1 0 0 1 0 0 1 0
0 1 0 1 0 1 1 1 0 1 1 1 1 0
3 1 1 1 1 1 0 1 1 1 0 0 1 3
0 0 0 0 1 0 0 1 0 1 0 0 0 0
3 1 1 1 1 1 0 1 1 1 0 0 1 3
0 1 0 1 0 1 1 1 0 1 1 1 1 0
0 0 0 1 0 0 1 0 0 1 0 0 1 0
0 2 1 1 1 1 1 0 2 1 1 1 2 0
0 0 0 0 0 0 0 0 0 0 0 0 0 0
mapagolge.png
